1111111111111
1E01000-000C1
1000011111001
1P0011E000001
1111111111111
